acro=heights
aero=air
agrio=farming
algia=pain
andro=man
anim=life
antho=flower
anthropo=human
aqua=water
arbor=tree
arthro=joint
art=skill
astro=star
avia=bird
bel=war
bene=good
biblio=book
bio=life
calc=stone
cardio=heart
carn=meat
chromo=color
chrono=time
cogni=knowledge
corpo=body
cosmo=universe
crypto=secret
demo=people
dent=tooth
derma=skin
domin=master
dox=belief
dynam=power
ego=self
esth=feeling
aesth=beauty
flora=flower
gastro=stomach
gene=birth
geo=earth
ger=old age
gon=angle
gram=writing
gyne=woman
helio=sun
hemo=blood
hepa=liver
herbi=plant
histo=tissue
hydro=water
hygro=moisture
icon=image
image=likeness
kine=motion
lacto=milk
later=side
leuko=colorless
lex=word
liber=freedom
lingu=language
lipo=fat
logo=word
lumin=light
luna=moon
mal=bad
manu=hand
mania=madness
mari=sea
mater=mother
medi=middle
melano=dark
memor=memory
morph=form
mort=death
myo=muscle
necro=dead
nephro=kidney
neuro=nerve
numer=number
nym=name
ocu=eye
od=path
odor=scent
osteo=bone
pater=father
path=emotion
pede=foot
phono=sound
photo=light
phys=nature
poli=city
pop=people
psych=mind
radic=root
radio=radiation
rhino=nose
sane=health
sci=knowledge
son=sound
soph=wisdom
taxo=arrangement
techno=technique
tempo=time
terra=earth
theo=god
thermo=heat
tox=poison
urb=city
vac=empty
vit=life
voc=voice
vol=wish
zoo=animal
