struct=build
scribe=write
cline=lean
flect=bend
funct=work
spect=look
scend=climb
tract=pull
junct=join
cede=go
cept=take
clus=close
dict=speak
duct=lead
grat=please
form=shape
fact=make
ject=throw
port=carry
rupt=break
judg=judge
migrat=move
narrat=tell
sect=cut
tact=touch
vent=come
vert=turn
act=do
aud=hear
fer=bring
fus=fuse
mit=send
nom=name
mut=change
pel=force
pon=place
put=think
pul=urge
rid=laugh
vis=see
vour=eat
donat=give
dur=last
gress=step
loqu=speak
lude=play
mand=order
plaud=approve
spir=breath
tort=twist
